00000000000000600000000000000
01111100022200000000000000000
01111100022200000000000000000
01111100044444440000000000000
01111100011111150011111000000
03333333344444440000000000000
00000000022222222222222222222
00000000022200700000000000000
00000000022200000000000000000
00414000022200000000000000000
00414000022200000000000000000
00411400022200000000000000000
00041400022200000000000000000
00041400022200000000000000000
00000000022200000000000000000
00041400022200000000000000000
00041444000000000000000000000
00041114000000000000000000000
00041114400000001111000000000
00041111130000001111000000000
00044444400000001111000000000
00000000000000000000000000000
00000000000000000000000000000
00000000000000000000000000000
00000000000000000000000000000
00000000000000000000000000000
00000000000000000000000000000
00000000000000000000000000000
00000000000000000000000000000