00000000000000000000000000000
01111222222200011111000000000
01111222222200014441000000000
01111200044400014441000000000
01111300011100014441000011000
02222200044400011111000011000
00000000022200000000000011000
00000000222200000002220011000
00011000222200000002220011000
00011000222222222222000000000
00000000222222222222000000000
00000000222200004222000000000
00414000222440004444000111100
00414000000440001111000111100
00414000000440671441000111100
00411400000440001111000111100
00041400000440004444000000000
00041400000440004222000000000
00000000222000002222000000000
00000000222000002222222222222
00000000222222222222222222222
00041400000000002222222222222
00041444000000004444444444444
00041114000000000011110000000
00041114400000000011110000110
00041111100050000011110000110
00044444400000000011110000000
00000000000000000000000000000
00000000000000000000000000000