00000000000000000000000000000
00000000000000000000000000000
00000000000000000000000000000
00000000002222222222222222000
00000000024444444444444444200
00000000241111050011110004200
00000000241111444411114404222
00000000241111444411114414444
00000000241111050011114410000
00000000245445252254454410000
00000000245445222254454410000
00000000241111050011114400000
00000000241111444411114400000
00000000241111444411114470000
00000000241111050011114460000
00000000024444444444444400000
00000000002222222222222444444
00000000000000000000000222222
00000000000000000000000000000
00000000000000000000000000000
00000000000000000000000000000
00000000000000000000000000000
00000000000000000000000000000
00000000000000000000000000000
00000000000000000000000000000
00000000000000000000000000000
00000000000000000000000000000
00000000000000000000000000000
00000000000000000000000000000
100