00000000000000000000000000000
00000000000000000000000000000
00000000000000000000000000000
00000000000000000000000000000
00000000000002222222222222222
00000000000002222222222222222
00000000000002221001011111000
00000000000002220220220220220
00000000000002220220220220220
00000000000002221111101005000
00000000000002220220221221220
00000000000002220220221221220
00000000000002211001001001000
00000000000002210220220220000
00000000000002210220220220000
00000000000002230222222227000
00000000000222200220000226000
00000000002240000220000220000
00000000002241114220000220000
00000000002241114220000220000
00000000002241114222222224444
00000000002244444000041114444
00000000002200000000441114400
00000000002204140000110001100
00000000002201510000110301100
00000000002204140000110001100
00000000002200000000441114400
00000000002200000000041114000
00000000002222222222222222222
100