00000220000300100000002000000
00002220222222400000002000000
00002440444200222222202222220
00002411114200000244404450042
00002411114200000241111422020
00002011114200000241111422020
00002044444200000241111022020
00002022222200000244442022020
00002020000000000222222322020
00002020000000000000022022020
00024142222220000000022022020
00024000000020000000024144142
00024000000020000000002000000
00024000000020000000002000700
00024142241420000000002000600
00002020020200000000002000000
00002020020200000000002000000
00002020020200000000002444444
00002020020222220000002222222
00002022220444442000000000000
00002005420111142000000000000
00002222224111142000000000000
00000000024111142000000000000
00000000024404442000000000000
00000000002202220000000000000
00000000000202222222000000000
00000000000200000412000000000
00000000000222222222000000000
00000000000000000000000000000
100