10001440000500030004444422222
04440440000500030004111422222
04445440000500030004111422222
04440440000500030004111422222
10501110004444444444444444442
44441110004222222222241411142
44441110004442000000244411142
40000001110042000000022411142
40000001310042000000002444442
40000001110042000000002000000
40004444003142000000002007000
40004224001142222222222006000
40004224444442222222222000000
40004222222220000000002000000
44444420000000000000002444444
41111420000000000000002222222
41111420000000000000000000000
41111420000000000000000000000
41111422222200000000000000000
44444444444200000000000000000
22411411114200000000000000000
22411411114200000000000000000
22444411114200000000000000000
22222411114200000000000000000
22222444444200000000000000000
22222222222200000000000000000
00000000000000000000000000000
00000000000000000000000000000
00000000000000000000000000000
100