00000000000000000000000000000
00000000000000000000000002222
00000000000000000022222221112
00000000000000000022424221112
00000000000000000024141401112
00000000000000000022424222022
00000002220000000022022222422
00000024442000000211120024142
00000244144222222211120002420
00000241001004004011120024142
00000244144222222222220222422
00000024442000000000000200000
00000002120000000000000200000
00000002120000000000000200700
00000024442000000000000200600
00000244144222222222220200000
00000241001004004011120200000
00000244144222222211120244444
00000024442000000211120222222
00000002220000000022022000000
00000000000000000022424222220
00000000000000000024141401112
00000000000000000022424221512
00000000000000000022222221112
00000000000000000000000002222
00000000000000000000000000000
00000000000000000000000000000
00000000000000000000000000000
00000000000000000000000000000
100