00000000000000000000000000000
00002222222222222222222000000
00021111111111500311104200000
00021111111111222222022222222
00021111111111200002101000042
00021111111111200002020222222
00021111111111200002101010042
00021111111111200002020222222
00021111111111200002021010142
00021111111111200002020202022
00021111111111200002020210142
00021111111111200002424222022
00002224042222000002222220000
00000024042000000000000020700
00000024042000000000000020600
00000002320000000000000020000
00000002020000000000000020000
00000002022222222200000024444
00000002000000000200000022222
00000002041404140200000000000
00000002010101010200000000000
00000002041404140200000000000
00000002000000000200000000000
00000002041404140200000000000
00000002010101010200000000000
00000002041404140222222222200
00000002000000000111411111200
00000002222222222222222222200
00000000000000000000000000000
100