00000000000000000000000000000
00000000000000000000000000000
00000002222222222222222222222
00000002222442222224422222222
00000002222442222224422222222
00000002000110000001100000000
00000002441111444411114400000
00000002441111444411114410000
00000002000110000001104010000
00000002245445222254454010000
00000002245445222254454010000
00000002000110050001104000000
00000002441111444411114000000
00000002441111444411114070000
00000002000110050001104060000
00000002222442222224444000000
00000002222442222224444444444
00000002222222222222222222222
00000000000000000000000000000
00000000000000000000000000000
00000000000000000000000000000
00000000000000000000000000000
00000000000000000000000000000
00000000000000000000000000000
00000000000000000000000000000
00000000000000000000000000000
00000000000000000000000000000
00000000000000000000000000000
00000000000000000000000000000
100