00000000000000000000000000000
00044444444444444440000000000
00022222222222222200000000000
00033333330000000000000000000
00004111110000000000000000000
00004111110000000000000000000
00004111110000000000000000000
00000000000000000000000000000
00000001111111111000000000000
00000001111111111000000000000
00000001111111111000000000000
00000001111111111000000000000
00000000000000000000000000000
00000000000000000000000000000
00000000000000000000000000000
00000000000000000000000000000
00000000000000000000000000000
00000000000000000000000000000
00000000000000000000000000000
00000000000000000000000000000
00000000000000000000000000000
00000000000000000000000000000
00000000000000000000000000000
00000000000000000000000000000
00000000000000000000000000000
00000000000000000000000000000
00000000000000000000000000000
00000000000000000000000000000
00000000000000000000000000000