00000000024000400000000000000
00000222224010401131151111020
00002444424000400004040001020
00002401044444200004140001020
00002411140004200004140001020
00222401040104200444144403020
00244444440004200111111101020
00240004444444200444144401020
00240104444422200004140005020
00240004010420000004140001020
00244444111420220000400001020
00222224010444442222222201020
00000024444401042000000200020
00000024000411142000000207020
00000024010401042200000206020
00000024000444444420000200020
00000024444444000420000200020
00000024001004010420000244420
00000024001004000420000222220
00000024113114444420000000000
00000024001004222200000000000
00000024001004200000000000000
00000024444444200000000000000
00000002222222000000000000000
00000000000000000000000000000
00000000000000000000000000000
00000000000000000000000000000
00000000000000000000000000000
00000000000000000000000000000
100