00000000000000000000000000000
00000000000000000000000002222
00000000000000222222000020000
00000000000002000002000200100
00000000000222020102002000000
00000000002000020102020110100
00000000020000020102201100100
00000000201100020102011020100
00000002000222220100110220100
00000020102000020101102020100
00000201020000020000020020100
00002010200000020100200020000
00020102000000020002000020000
00201020000000022220000020700
00200200000000000022220020600
00212222220000000211112020000
00211501112220000212212020000
00222221110112022212212024444
00000021112212211111112022222
00000002220202212212220000000
00000000000212212212000000000
00000000000211011112000000000
00000000000022222220000000000
00000000000000000000000000000
00000000000000000000000000000
00000000000000000000000000000
00000000000000000000000000000
00000000000000000000000000000
00000000000000000000000000000
100