00000000000020000000004444200
00000000000020000000004114200
00000000000020000000004114200
00000002000021224444404444200
00000024200020204411400022200
00000241420020204411400020000
00002441442220204444400020000
00024110040410204411400020000
00002441442220204411400020000
00000244420020204444400022220
00000020200025204411400000020
00222220222220204411400000020
00200001000024204444444440020
00202222222222222222222222020
00212200411411411220000002720
00252202222222221222222222620
00212232000000021211111112020
00212212000000021212222212020
00252212000000021212111212420
00212252000000021212121212220
00212212000000021212121212000
00232212000000021212221212000
00202252000000021211111212000
00242212000000021222222212000
00211112000000021111111112000
00211112000000002222222220000
00211112000000000000000000000
00211112000000000000000000000
00222222000000000000000000000
100