00000000000000000000000041111
00000000000111111111100041111
00000000000000000000000041111
00044401110444444444444441111
00044401110422222222222224444
00044401110420000000000024000
00000010000420000000000024010
00011104444420000000000024010
00011104222220000000000024010
00011104220000000000000024010
00000004220000000000000024000
00000444220000000000000024333
00000422000000000000000024000
00070422000000000000000024010
00060422000000000000000024010
00000422000000000000000024010
00000422000000000000000024000
00000422222222200000000024333
44444422000002200000000024000
44444422011102200000000024000
00000422011102200000000024000
00000422011102200000000024010
00000422000052222222222224010
00000444022204444444444444010
00000000100010000000004444010
00000000000000011111005111110
00000000000000000000004444444
00000000000000000000000000000
00000000000000000000000000000
100