00000000000000002222222222000
22222000000000002111400002000
21114011104111034111401102000
21112000000000002111400002000
20002222222222222222200222220
20012222222220000211100000020
20010400011120000211101110020
22222222000020000222220000020
02111003011120000000020070020
02000002222220000000020060020
02000002000000000000020000020
02010002200000000000022222220
02212220000000000000000000000
00212000000000000000000000000
00212000000000000000000000000
00252000000000000000000000000
22202222222222222000000000000
00000000411141112000000000000
01102222222221112000000000000
01102000000021112000000000000
00002000000022222000000000000
22222000000000000000000000000
00000000000000000000000000000
00000000000000000000000000000
00000000000000000000000000000
00000000000000000000000000000
00000000000000000000000000000
00000000000000000000000000000
00000000000000000000000000000
60