24444000000000004444000222222
24111000000000004111000000222
24111000011100003111000110222
24111000000000004111000000222
24000444444442024444000222222
24111030011142024444000222222
24111030011142024111000000000
24111030011142024111000111000
24444444400042024111000000000
24111003011142024444220000000
24111003011142022222220007000
24111003011142000000220006000
24000002244442000000220000000
22000002222222000000220000000
22010002200000000000224444444
22212220000000000000022222222
22212220000002222222000000000
22212220000024444444200000000
22252220000024111114200000000
22202222222224111114200000000
20000000411104111114200000000
01102222222224111114200000000
01102200000024111114200000000
00002200000024444444200000000
22222000000002222222000000000
00000000000000000000000000000
00000000000000000000000000000
00000000000000000000000000000
00000000000000000000000000000
100