00220220220000222222220000020
00220220220000000000220111020
00001001001000000000220111020
00220220220220000000220111020
00220220220220222200220000020
00001001001000200020022252320
00220220220220200002002202020
00220220220220200000200200020
00001001001000200000020010020
00220220220220200000022204420
00220220220220200000000202220
00001111001000200000000202222
00000220220110200000000200000
00000220220110200000000207000
00000000000000200000000206000
00000000000000200000000020000
22222222244444200000000020000
00000000241114200000000024444
00000000241314200000000022222
00000000241114200000000000000
00000000244444200000000000000
00000000222414200000000000000
00111110044444200000000000000
00111110041114200000000000000
00111110041314200000000000000
00111110041114200000000000000
00111110044444200000000000000
00000000022222200000000000000
00000000000000000000000000000
100