00000000000000000000000000000
22222222222222222222222222222
22222222222222222222222222222
00001111030003000300111100000
00001444444444444444444100000
00001444422222222224444100000
01113111420000000024111111100
01441441420000000024144140100
01441441444420024444544140100
01441151111420024111111140100
00444441111420024111144440100
00420241111420024111142240000
03420241111420024111142240000
01420244444420024444442240700
01420222222220022222222240600
00420244444420000000000240000
03420241111420000000000240000
00420241111420000000000240000
00444441111420000000000044444
01441111111420000000000044444
01441445444420000000000000000
01441441422200000000000000000
01113111420000000000000000000
00000444420000000000000000000
22222222220000000000000000000
00000000000000000000000000000
00000000000000000000000000000
00000000000000000000000000000
00000000000000000000000000000
100