00002000020000400400400400111
00000200020000040040040040111
00010020020100004004004004111
00000002020100400400400400400
00010110220100240040111110040
00010011020100224004111114004
00010001100100202400111110400
00010000110100200240111110040
00010020000000200024111114004
00010022000100200002400400400
00030020200000200000240040040
00000020020000200000024004004
00010020002000200000002220000
00010022222222222222222220700
00030022222222000000000020600
00000024444442000000000020000
00011001101142000000000020000
44444444444142000000000024444
01111102004042000000000022222
01000102004142000000000000000
01000102224142000000000000000
01111100004042000000000000000
00000111104142000000000000000
00000100104142000000000000000
00000100104042000000000000000
00000100104042000000000000000
00000111104042000000000000000
00000000004042000000000000000
00000000004442000000000000000
100