00000000000000000000000000000
00000000000000000000000000000
00000000000000000000000000000
00000000000000000000000000000
00000000000000000000000000000
00000000000000000000000000000
22222222222222222222222222222
22222222222222222222222222222
00000000000022022000444444400
00000000000022022000411111140
00011110000022022000414444040
00011110000022022444414220300
00011110000022022441114220000
00011110010022022441444220000
00000000010022022441444220100
00000220010022022441444220100
00010220000022022441444220100
00010220000022022000000220100
00010224414422222000000220000
00010224414400000001000220000
00010224414400000001000220110
00010224414400000001000220110
00000224411140000001000220000
00000220044144444000000220000
00070220004111110300000220000
00060220000444444000000220000
00000220000444444000000220000
00000220000444444000000220000
00000220000444444000000220000
100