11111111111111111111111111111
10000000000000000000000000001
10000000000000000000000000001
10000000000000000000000000001
10000000000000000000000000001
10000000000000000000000000001
12222222222222222222222222221
12222222222222222222222222221
10000000000022022000444444401
10000000000022022000411111141
10011110000022022000414444041
10011110000022022444414220301
10011110000022022441114220001
10011110010022022441444220001
10000000010022022441444220101
10000220010022022441444220101
10010220000022022441444220101
10010220000022022000000220101
10010224414422222000000220001
10010224414400000001000220001
10010224414400000001000220111
10010224414400000001000220111
10000224411140000001000220001
10000220044144444000000220001
10070220004111110300000220001
10060220000444444000000220001
10000220000444444000000220001
10000220000444444000000220001
11111111111111111111111111111
100